--------------------------------------------------------------------------------------------------------------------------------------------------------------------------------------------------------
--------------------------------------------------------------------------------------------------------------------------------------------------------------------------------------------------------
--------------------------------------------------------------------------------------------------------------------------------------------------------------------------------------------------------
--------------------------------------------------------------------------------------------------------------------------------------------------------------------------------------------------------
--------------------------------------------------------------------------------------------------------------------------------------------------------------------------------------------------------
--------------------------------------------------------------------------------------------------------------------------------------------------------------------------------------------------------
---------------------------------------------------------------------------------------------------------------------------------X----------------------------------------------------------------------
-------------------------------------------------------------------------------------------------------------------------------------------------------------------------------------------------------v
-------------------------------------------------------------------------------------------------------------------------------------------------------------------------------------------------------f
---------------------------------------------------------B--o-------------------------------------------------------------------B----------------X------------------oX-X-------------------------------f
----------B-----------------------------------------------------X------------------------------------------------------------------------------------BB----------------------------------------------B-f
------------------T-------B-----------------------------------------------------------------------------------------------------oM------------------------------------------------------------TB-------f
--------T--BX-----|-----B---------o------------T--------X------B--X----------------------------------------------------T--------------------------?---------X-------B-----T-----T---B---------|--------f
--------|---------T------X--------T-B------X---|-------------B-------------T-X------------T----------------------------|--------------T---------------------T----------T--|-----|--o------oB--|--------f
m---?---|---------|-----?---------|------o-----|-----------------------X---|--------------|-?------E--------X----------|-----------M--|--------M------------|----------|--|-----|-------------|--------X
XXXXXXXX|XXXXXXXXX|XXXXXXXXXXX-XXX|XX--XXXXXXXX|XXXX-XXXXXXXXXXXXXXXXXXXXXX|XXXX-XXXXXXXXXXXXXXXXXXXXXXXXXXXXXXXXXXXXXX|XXXXXXXXXXXXXX|XXXXXXXXXXXXXXXXXXXXXXXXXXXXXXXXXXX|XXXXX|XXXXXXXXXXXXXXXX--XXXXX
